##########################
#....M...................#
#.###### #####.#.######..#
#......# #...#........#..#
#......# ##.##...####.#..#
#...####.........#....#..#
#......#.........######..#
#.........##.............#
#......#..............@..#
#...M..####......###.....#
#........................#
##########################